R 2000 1000

F 100,100,215
C 130,200,215

EA ./textures/east.xpm
NO ./textures/nouth.xpm
SO ./textures/south.xpm
WE ./textures/west.xpm

S ./textures/barrel.xpm

11                              
        1111111111111111111111111
    1  10000000011E000000000 011
   11 10110000111000200200  001
    1  1001000 000000000011 11111
111111111011000001110000000000001
100000000011000001110111111111111
1111011111111101111000001000111
11110111111111011100010010001
11000000110101011110000010001  
1000200000000000000000010001   
10000000000000001101010010001
11000001110101011111011000111     
11110111 1110101 101111010001                                     
11111111 1111111 11111111111                                     
11111111 1111111 111111111111                                      
      1